1111111111111111111111111111111111111111111
1100P00111100000000000000111100000000000011
110000011110000000C0000001111000000C0000011
1100000000000000000000000000000000000000011
1100000000000000111100000000000000000000011
1100000000000000000000000000000000111111111
1100000011111110000001110000000000111111111
1100000011111110000001110000C00000111111111
1100000011111110000001110000000000000000011
1100000000000000000000000000000000000000011
1100000000000000000000000011111100000000011
1100000001111111000000000011111100000000011
1100000001111111110000000011111111000000011
11C0000001111111110000000011111111000000011
1100000001111111110000000011111111000000011
1100000001111111110000000011111111110000011
1100000001111111110000000011111111110000011
1111111111111111110000000001111111110000011
1111111111111111110000000000000111110000011
1111111111111111110000000000000111110000011
11111111111111111100000C0000000111110000011
1111111111111111110000000000000111110000011
11000C0000000000000000000000000000000000011
1100000000000000000000000000000000000000011
1100000000000000000000000000000000000000011
11000000000000000000000000000000000000C0011
1100000000000001110000000011100000000000011
1100C00000011111110000000011100000000000011
1100000000011111110000000011100000000000011
1100000000011111110000000011100000000000011
110000000000000000000000000000000000E000011
1111111111111111111111111111111111111111111